WE ./textures/dlv_metalpan4a.png
EA ./textures/dlv_metaltrm4c.png
NO ./textures/dlv_metaltrm4a.png
SO ./textures/dlv_metaltrm1b.png
FT ./textures/dlv_metalstr1b.png
CT ./textures/dlv_wood2c.png

C 255,30,100
F 220,0,0

        1111111111111111111111111
        1000000000110000000000001
        1011000001110000000000001
        1001000000000000000000001
111111111011000001110000000000001
10000000011000001110111111111111
1111011111111011100000010001
1111011111111011101010010001
110000011010111100000010001
1000N00000000001100000010001
1000000000000001101010010001
110000011010101111101111000111
111101111101011011110100011
11111111111111111111111111111

