WE ./textures/dlv_metalpan4a.png
EA ./textures/dlv_metaltrm4c.png








NO ./textures/dlv_metaltrm4a.png
SO ./textures/dlv_metaltrm1b.png
C 225,30,100
F 220,0,0

1111111111111111111111111
1000000000110000000000001
1011000001110000000000001
100100000000000000000000111111111
111111111011000001110000000000001
10000000011000001110111111111111
11110111111111011100000010001
11110111111111011101010010001
11000000110101011100000010001
1000000000000001100000010001
10000000000000001101010000001
11000001110101011111011110N0111
1111011111101011011110100011
111111111111111111111111111

