WE ./textures/dlv_metalpan4a.png
EA ./textures/dlv_metaltrm4c.png
NO ./textures/dlv_metaltrm4a.png

SO ./textures/dlv_metaltrm1b.png

FT ./textures/dlv_metalstr1b.png
CT ./textures/dlv_wood2c.png

C 225,30,100
F 220,0,0


1111111111111111111111111
100000000110000000000001
1011000001110000000000001
100100000000000000000000111111111
1111111110111000001110000000000001
10000000001 1000001110111111111111
11110111111111011100000010001
11110111111111011101010010001
11000000110101011100000010001
10000000001000011000000000001
10000000000000001101010010001
11000001110101011111011110N0111
1111011111101011011110100011
111111111111111111111111111

